"filename", "language", "Python", "Markdown", "Jupyter (JSON)", "comment", "blank", "total"
"/Users/will/Documents/msci-brem-reconstruction/README.md", "Markdown", 0, 1, 0, 0, 0, 1
"/Users/will/Documents/msci-brem-reconstruction/rashid_test/E_gun_data_prep.py", "Python", 107, 0, 0, 85, 39, 231
"/Users/will/Documents/msci-brem-reconstruction/rashid_test/Jpsi_data_prep.py", "Python", 136, 0, 0, 23, 39, 198
"/Users/will/Documents/msci-brem-reconstruction/rashid_test/ML_models.py", "Python", 419, 0, 0, 56, 83, 558
"/Users/will/Documents/msci-brem-reconstruction/rashid_test/Recreating_plot_masses.py", "Python", 64, 0, 0, 15, 38, 117
"/Users/will/Documents/msci-brem-reconstruction/rashid_test/pp_data_prep.py", "Python", 18, 0, 0, 5, 4, 27
"/Users/will/Documents/msci-brem-reconstruction/src/__init__.py", "Python", 0, 0, 0, 0, 1, 1
"/Users/will/Documents/msci-brem-reconstruction/src/brem_reg.py", "Python", 156, 0, 0, 0, 23, 179
"/Users/will/Documents/msci-brem-reconstruction/src/electron_gun.py", "Python", 381, 0, 0, 17, 35, 433
"/Users/will/Documents/msci-brem-reconstruction/src/graphing.ipynb", "Jupyter (JSON)", 0, 0, 197, 0, 1, 198
"/Users/will/Documents/msci-brem-reconstruction/src/main.py", "Python", 20, 0, 0, 1, 7, 28
"/Users/will/Documents/msci-brem-reconstruction/src/plot_energy_curves.py", "Python", 11, 0, 0, 0, 5, 16
"/Users/will/Documents/msci-brem-reconstruction/src/psiK.py", "Python", 744, 0, 0, 20, 108, 872
"/Users/will/Documents/msci-brem-reconstruction/src/pythia.py", "Python", 4, 0, 0, 0, 3, 7
"/Users/will/Documents/msci-brem-reconstruction/src/reco.py", "Python", 7, 0, 0, 3, 4, 14
"/Users/will/Documents/msci-brem-reconstruction/src/utils.py", "Python", 120, 0, 0, 2, 34, 156
"Total", "-", 2187, 1, 197, 227, 424, 3036